 VBA = "countries/BagmatiPradesh.txt"
 VBB = "countries/GandakiPradesh.txt"
 VBC = "countries/Garhwal.txt"
 VBD = "countries/Arunachal.txt"
 VBE = "countries/Naag.txt"
 VBF = "countries/Assum.txt"
 VBG = "countries/Kochh.txt"
 VBH = "countries/Jalpaiguri.txt"
 VBI = "countries/Chittagong.txt"
 VBJ = "countries/Buriganga.txt"
 VBK = "countries/Rajshahi.txt"
 VBL = "countries/Jessor.txt"
 VBM = "countries/Sundarban.txt"
 VBN = "countries/Bardwan.txt"
 VBO = "countries/Saharanpur.txt"
 VBP = "countries/Sirhindh.txt"
 VBQ = "countries/Patialah.txt"
 VBR = "countries/Dilli.txt"
 VBS = "countries/Brijbhoomi.txt"
 VBT = "countries/Kanpur.txt"
 VBU = "countries/Chambal.txt"
 VBV = "countries/Bundi.txt"
 VBW = "countries/Raebareli.txt"
 VBX = "countries/Awadh.txt"
 VBY = "countries/Varanasi.txt"
 VCA = "countries/Bareli.txt"
 VCB = "countries/Bhanbhor.txt"
 VCC = "countries/Larkan.txt"
 VCD = "countries/Bahawulpur.txt"
 VCE = "countries/Shahpur.txt"
 VCF = "countries/Lahore.txt"
 VCG = "countries/Sahiwal.txt"
 VCH = "countries/Peshawar.txt"
 VCI = "countries/Kangara.txt"
 VCJ = "countries/Kashmeer.txt"
 VCK = "countries/Magadh.txt"
 VCL = "countries/Kushinagar.txt"
 VCM = "countries/Katihar.txt"
 VCN = "countries/Maithili.txt"
 VCO = "countries/Jodhpur.txt"
 VCP = "countries/Ajmer.txt"
 VCQ = "countries/Udaipur.txt"
 VCR = "countries/Amber.txt"
 VCS = "countries/Bikaner.txt"
 VCT = "countries/Surat.txt"
 VCU = "countries/Patan.txt"
 VCV = "countries/Saurashtra.txt"
 VCW = "countries/Nagpur.txt"
 VCX = "countries/Singrauli.txt"
 VCY = "countries/Jagdalpur.txt"
 VCZ = "countries/Jharkhand.txt"
 VDA = "countries/Ujjain.txt"
 VDB = "countries/Indore.txt"
 VDC = "countries/Bhopal.txt"
 VDD = "countries/Sundargarh.txt"
 VDE = "countries/Kalahandi.txt"
 VDF = "countries/Bhadrak.txt"
 VDG = "countries/Puri.txt"
 VDH = "countries/Belgavi.txt"
 VDI = "countries/Daulatabad.txt"
 VDJ = "countries/Amravati.txt"
 VDK = "countries/Raichur.txt"
 VDL = "countries/Pune.txt"
 VDM = "countries/Konkan.txt"
 VDN = "countries/Kolhapur.txt"
 VDO = "countries/Hydrabad.txt"
 VDP = "countries/Warangal.txt"
 VDQ = "countries/Guntur.txt"
 VDR = "countries/Godavari.txt"
 VDS = "countries/Kanara.txt"
 VDT = "countries/Malappuram.txt"
 VDU = "countries/Kottayam.txt"
 VDV = "countries/Rayalaseema.txt"
 VDW = "countries/Tirupati.txt"
 VDX = "countries/Mysuru.txt"
 VDY = "countries/Cuddalore.txt"
 VDZ = "countries/Nagapattinam.txt"
 VEA = "countries/Virudhunagar.txt"
 VEB = "countries/Dharmapuri.txt"
 VEC = "countries/Tiruppur.txt"
 VEF = "countries/Kachin.txt"
 VEG = "countries/Magwe.txt"
 VEH = "countries/Bago.txt"
 VEI = "countries/Yangon.txt"
 VEJ = "countries/Rakhaing.txt"
 VEK = "countries/Ampara.txt"
 VEL = "countries/Puttalam.txt"
 VEM = "countries/Purvanchal.txt"   